Details,Posting Date,"Description",Amount,Type,Balance,Check or Slip #,
CREDIT,5/21/2014,"INTEREST PAYMENT",1.26,MISC_CREDIT,155746.39,,
CREDIT,4/21/2014,"INTEREST PAYMENT",1.30,MISC_CREDIT,155745.13,,
CREDIT,3/21/2014,"INTEREST PAYMENT",1.05,MISC_CREDIT,155743.83,,
CREDIT,2/24/2014,"INTEREST PAYMENT",1.39,MISC_CREDIT,155742.78,,
DEBIT,2/11/2014,"Online Transfer to CHK ...8867 transaction#: 3745322035 02/11",-10000.00,ACCT_XFER,155741.39,,
CREDIT,1/23/2014,"INTEREST PAYMENT",1.61,MISC_CREDIT,165741.39,,
DEBIT,1/21/2014,"Payment to Chase card ending in 1412 01/21",-10000.00,ACCT_XFER,165739.78,,
